FILE_TYPE=VERILOG_MAP;
PRIMITIVE 'UPF1765';
    DEFAULT_MODEL=SNOF1765;
    UPPER_CASE=TRUE;
    MODEL 'SNOF1765';
        PIN_MAP
            '-SEL1'='(sel1)';
            'RCP'='(RCP)';
            'CP'='(CP)';
            'WG'='(WG)';
            'GNT'='(GNT)';
            '-CASEN'='(CASEN)';
            'DTACK'='(DTACK)';
            '-RAS'='(RAS)';
            '-REQ2'='(req2)';
            '-REQ1'='(req1)';
            '-SEL2'='(sel2)';
            'MA0'='(MA[0])';
            'MA1'='(MA[1])';
            'MA2'='(MA[2])';
            'MA3'='(MA[3])';
            'MA4'='(MA[4])';
            'MA5'='(MA[5])';
            'MA6'='(MA[6])';
            'MA7'='(MA[7])';
            'MA8'='(MA[8])';
            'MA9'='(MA[9])';
            'CA0'='(CA[0])';
            'CA1'='(CA[1])';
            'CA2'='(CA[2])';
            'CA3'='(CA[3])';
            'CA4'='(CA[4])';
            'CA5'='(CA[5])';
            'CA6'='(CA[6])';
            'CA7'='(CA[7])';
            'CA8'='(CA[8])';
            'CA9'='(CA[9])';
            'RA0'='(RA[0])';
            'RA1'='(RA[1])';
            'RA2'='(RA[2])';
            'RA3'='(RA[3])';
            'RA4'='(RA[4])';
            'RA5'='(RA[5])';
            'RA6'='(RA[6])';
            'RA7'='(RA[7])';
            'RA8'='(RA[8])';
            'RA9'='(RA[9])';
        END_PIN;
    END_MODEL;
END_PRIMITIVE;
END.
