FILE_TYPE=VERILOG_MAP;
PRIMITIVE 'CONN90_JACK';
    DEFAULT_MODEL=CONN90_JACK;
    UPPER_CASE=TRUE;
    MODEL 'CONN90_JACK';
        PIN_MAP
            'PIN1'='(PIN1)';
            'PIN2'='(PIN2)';
            'PIN3'='(PIN3)';
            'PIN4'='(PIN4)';
            'PIN5'='(PIN5)';
            'PIN6'='(PIN6)';
            'PIN7'='(PIN7)';
            'PIN8'='(PIN8)';
            'PIN9'='(PIN9)';
            'PIN10'='(PIN10)';
            'PIN11'='(PIN11)';
            'PIN12'='(PIN12)';
            'PIN13'='(PIN13)';
            'PIN14'='(PIN14)';
            'PIN15'='(PIN15)';
            'PIN16'='(PIN16)';
            'PIN17'='(PIN17)';
            'PIN18'='(PIN18)';
            'PIN19'='(PIN19)';
            'PIN20'='(PIN20)';
            'PIN21'='(PIN21)';
            'PIN22'='(PIN22)';
            'PIN23'='(PIN23)';
            'PIN24'='(PIN24)';
            'PIN25'='(PIN25)';
            'PIN26'='(PIN26)';
            'PIN27'='(PIN27)';
            'PIN28'='(PIN28)';
            'PIN29'='(PIN29)';
            'PIN30'='(PIN30)';
            'PIN31'='(PIN31)';
            'PIN32'='(PIN32)';
            'PIN33'='(PIN33)';
            'PIN34'='(PIN34)';
            'PIN35'='(PIN35)';
            'PIN36'='(PIN36)';
            'PIN37'='(PIN37)';
            'PIN38'='(PIN38)';
            'PIN39'='(PIN39)';
            'PIN40'='(PIN40)';
            'PIN41'='(PIN41)';
            'PIN42'='(PIN42)';
            'PIN43'='(PIN43)';
            'PIN44'='(PIN44)';
            'PIN45'='(PIN45)';
            'PIN46'='(PIN46)';
            'PIN47'='(PIN47)';
            'PIN48'='(PIN48)';
            'PIN49'='(PIN49)';
            'PIN50'='(PIN50)';
            'PIN51'='(PIN51)';
            'PIN52'='(PIN52)';
            'PIN53'='(PIN53)';
            'PIN54'='(PIN54)';
            'PIN55'='(PIN55)';
            'PIN56'='(PIN56)';
            'PIN57'='(PIN57)';
            'PIN58'='(PIN58)';
            'PIN59'='(PIN59)';
            'PIN60'='(PIN60)';
            'PIN61'='(PIN61)';
            'PIN62'='(PIN62)';
            'PIN63'='(PIN63)';
            'PIN64'='(PIN64)';
            'PIN65'='(PIN65)';
            'PIN66'='(PIN66)';
            'PIN67'='(PIN67)';
            'PIN68'='(PIN68)';
            'PIN69'='(PIN69)';
            'PIN70'='(PIN70)';
            'PIN71'='(PIN71)';
            'PIN72'='(PIN72)';
            'PIN73'='(PIN73)';
            'PIN74'='(PIN74)';
            'PIN75'='(PIN75)';
            'PIN76'='(PIN76)';
            'PIN77'='(PIN77)';
            'PIN78'='(PIN78)';
            'PIN79'='(PIN79)';
            'PIN80'='(PIN80)';
            'PIN81'='(PIN81)';
            'PIN82'='(PIN82)';
            'PIN83'='(PIN83)';
            'PIN84'='(PIN84)';
            'PIN85'='(PIN85)';
            'PIN86'='(PIN86)';
            'PIN87'='(PIN87)';
            'PIN88'='(PIN88)';
            'PIN89'='(PIN89)';
            'PIN90'='(PIN90)';
        END_PIN;
    END_MODEL;
END_PRIMITIVE;
END.
