FILE_TYPE=VERILOG_MAP;
PRIMITIVE 'CONN96';
    DEFAULT_MODEL=CONN96;
    UPPER_CASE=TRUE;
    MODEL 'CONN96';
        PIN_MAP
            'C32'='(C32)';
            'C31'='(C31)';
            'C30'='(C30)';
            'C29'='(C29)';
            'C28'='(C28)';
            'C27'='(C27)';
            'C26'='(C26)';
            'C25'='(C25)';
            'C24'='(C24)';
            'C23'='(C23)';
            'C22'='(C22)';
            'C21'='(C21)';
            'C20'='(C20)';
            'C19'='(C19)';
            'C18'='(C18)';
            'C17'='(C17)';
            'C16'='(C16)';
            'C15'='(C15)';
            'C14'='(C14)';
            'C13'='(C13)';
            'C12'='(C12)';
            'C11'='(C11)';
            'C10'='(C10)';
            'C9'='(C9)';
            'C8'='(C8)';
            'C7'='(C7)';
            'C6'='(C6)';
            'C5'='(C5)';
            'C4'='(C4)';
            'C3'='(C3)';
            'C2'='(C2)';
            'C1'='(C1)';
            'B32'='(B32)';
            'B31'='(B31)';
            'B30'='(B30)';
            'B29'='(B29)';
            'B28'='(B28)';
            'B27'='(B27)';
            'B26'='(B26)';
            'B25'='(B25)';
            'B24'='(B24)';
            'B23'='(B23)';
            'B22'='(B22)';
            'B21'='(B21)';
            'B20'='(B20)';
            'B19'='(B19)';
            'B18'='(B18)';
            'B17'='(B17)';
            'B16'='(B16)';
            'B15'='(B15)';
            'B14'='(B14)';
            'B13'='(B13)';
            'B12'='(B12)';
            'B11'='(B11)';
            'B10'='(B10)';
            'B9'='(B9)';
            'B8'='(B8)';
            'B7'='(B7)';
            'B6'='(B6)';
            'B5'='(B5)';
            'B4'='(B4)';
            'B3'='(B3)';
            'B2'='(B2)';
            'B1'='(B1)';
            'A32'='(A32)';
            'A31'='(A31)';
            'A30'='(A30)';
            'A29'='(A29)';
            'A28'='(A28)';
            'A27'='(A27)';
            'A26'='(A26)';
            'A25'='(A25)';
            'A24'='(A24)';
            'A23'='(A23)';
            'A22'='(A22)';
            'A21'='(A21)';
            'A20'='(A20)';
            'A19'='(A19)';
            'A18'='(A18)';
            'A17'='(A17)';
            'A16'='(A16)';
            'A15'='(A15)';
            'A14'='(A14)';
            'A13'='(A13)';
            'A12'='(A12)';
            'A11'='(A11)';
            'A10'='(A10)';
            'A9'='(A9)';
            'A8'='(A8)';
            'A7'='(A7)';
            'A6'='(A6)';
            'A5'='(A5)';
            'A4'='(A4)';
            'A3'='(A3)';
            'A2'='(A2)';
            'A1'='(A1)';
        END_PIN;
    END_MODEL;
END_PRIMITIVE;
END.
